000000000
011101110
011101110
011101110
011101110
033303330
000000000
000000000
000000000
000000000
